MICEXINDEXCF	Индекс ММВБ
MICEXFNL	Индекс ММВБ FNL
MICEXLC	Индекс ММВБ LC
MICEXMC	Индекс ММВБ MC
MICEXSC	Индекс ММВБ SC
MICEXMNF	Индекс ММВБ-Машиностроение
MICEXMANDM	Индекс ММВБ-Металлургия
MICEXOANDG	Индекс ММВБ-Нефть и Газ
MICEXTLC	Индекс ММВБ-Телекоммуникации
MICEXPWR	Индекс ММВБ-Энергетика
MICEX10INDEX	ММВБ Индекс ММВБ10
MICEXTECHIND	ТехИндекс ММВБ
SCOH	7Континент
AVAZ	АВТОВАЗ
AVAZPP	АВТОВАЗ пр.
SVZB	АКБ Связь-Банк
ARMD	АРМАДА
AFKC	АФК Система
RU14AVAN8010	Авангард
AKRN	Акрон
RU14APTK1007	Аптечная сеть 36,6
ARSA	Арсагера
ASSB	АстраханьЭнергоСбыт
AMEZ	Ашинский метзавод
AFLT	Аэрофлот
PKBA	Балтика
PKBAP	Балтика пр.
VTBR	Банк ВТБ
VTBS	Банк ВТБ Северо-Запад
VTBR-002D	Банк ВТБ-002D
VZRZ	Банк Возрождение
VZRZP	Банк Возрождение пр.
MMBM	Банк Москвы
BSPB	Банк Санкт-Петербург
TAVR	Банк Таврический
RU14BISV1003	БашИнСвязь-1
RU14BISV1011	БашИнСвязь-1 пр.
RU14BISV2001	БашИнСвязь-2
RU14BISV2019	БашИнСвязь-2 пр.
RU14BISV4007	БашИнСвязь-4
RU14BISV4015	БашИнСвязь-4 пр.
BEGY	БашкирЭн
BELO	Белон
BACT	БизнесАктив
BUSB	БурятЭнергоСбыт
VFRM	ВЕРОФАРМ
RU14VOST1005	ВНК
VSMO	ВСМПО-АВИСМА
WBDF	Вимм-Билль-Данн ПП
VLHZ	ВладимирХимЗавод
VDSB	ВладимирЭнергоСбыт
VTEL	ВолгаТелеком
VTELP	ВолгаТелеком пр.
VGSB	ВолгоградЭнергоСбыт
VGSBP	ВолгоградЭнергоСбыт пр.
VTGK	Волжская ТГК
VOSB	ВологдаСбытКомпания
VRSB	ВоронежЭнергоСбыт
VRSBP	ВоронежЭнергоСбыт пр.
VSMZ	Выксунский метзавод
RU0008913751	ГУМ
GAZP	Газпром
SIBN	Газпром нефть
PIKK	Группа Компаний ПИК
LSRG	Группа ЛСР
GRAZ	Группа РАЗГУЛЯЙ
GCHE	Группа Черкизово
FESH	ДВМП
DIXY	ДИКСИ Групп
DIXY-002D	ДИКСИ Групп-002D
DVEC	ДЭК
DASB	ДагестанЭнергоСбыт
DLVB	Дальневосточный банк
DLVBP	Дальневосточный банк пр.
DLSV	Дальсвязь
DLSVP	Дальсвязь пр.
DGBZ	Дорогобуж
DGBZP	Дорогобуж пр.
TGK13	Енисейская ТГК (ТГК-13
ERMK	Ермак-инвест
ZMZN	Заволжский мотозавод
ZMZNP	Заволжский мотозавод пр.
IRAO	ИНТЕР РАО ЕЭС
IRKT	ИРКУТ
IKAR	Икар
ILSO	Илецксоль
ISKJ	Институт СКЧ
RU14INUR2017	Интерурал-2
IRGZ	ИркутскЭн
KMAZ	КАМАЗ
YRSL	КБ Ярославич
KUOS	КНОС
AZKM	КОАО Азот
CMST	КОМСТАР-ОТС
KHEL	Казанский вертолетный з-д
KLSB	КалугаСбытКомпания
KCHE	КамчатскЭн
KCHEP	КамчатскЭн пр.
KISB	КировЭнергоСбыт
KISBP	КировЭнергоСбыт пр.
KCXK	Кирово-Чепецкий ХК
KMEZ	Ковровский МЗ
KOSB	КолЭнергоСбыт
RU0009119986	КомиТЭК
MVID	Компания М.видео
KLNA	Концерн КАЛИНА
BENR	КорСсис
BENRP	КорСсис пр.
KOGK	Коршуновский ГОК
KTSB	КостромаСбытКомпания
KTSBP	КостромаСбытКомпания пр.
KZMS	Краснокамский ЗМС
KRSB	КрасноярскЭнергоСбыт
KRSBP	КрасноярскЭнергоСбыт пр.
KRSG	Красноярская ГЭС
KROT	Красный Октябрь
RU0008913868	Красный Октябрь пр.
KUST	Кубанская степь
KUBE	КубаньЭн
KBSB	КубаньЭнергоСбыт
KZBN	КузбассЭн
KUSB	Курская ЭСК
KUSBP	Курская ЭСК пр.
LKOH	ЛУКОЙЛ
LSNG	ЛенЭн
LSNGP	ЛенЭн пр.
LNZL	Лензолото
LNZLP	Лензолото пр.
LPSB	ЛипецкЭнергоСбыт
RU14MBSP7002	МБСП
RU14MGTS2012	МГТС-4 пр.
RU14MGTS5007	МГТС-5
URSAP	МДМ Банк пр.
MERF	МЕРИДИАН
MTLR	МЕЧЕЛ
MAGN	ММК
MSRS	МОЭСК
MRKV	МРСК Волги
MRKK	МРСК Северного Кавказа
MRKZ	МРСК Северо-Запада
MRKS	МРСК Сибири
MRKU	МРСК Урала
MRKC	МРСК Центра
MRKP	МРСК Центра и Приволжья
MRKA	МРСК Юга
MTSI	МТС
MGNT	Магнит
RU0009011126	МегионНГ
RU0009011134	МегионНГ пр.
MGOK	Михайловский ГОК
MRSB	МордовияЭнергоСбыт
MSNG	МосЭн
MSSB	МосЭнергоСбыт
MSSV	Московская ТеплоСеть
MNPZ	Московский НПЗ
MOTZ	Мотовилихинские заводы
NEKK	НЕКК
NLMK	НЛМК
NOTK	НОВАТЭК
VZLT	НПО Взлет
VZLTP	НПО Взлет пр.
NPE1	НПО Промавтоматика
NTRI	НУТРИНВЕСТХОЛДИНГ
NNSB	НижегородСбытКомпания
NNSBP	НижегородСбытКомпания пр.
RU14NZGZ2006	НижневартовскНГ
RU14NZGZ2014	НижневартовскНГ пр.
NKNC	НижнекамскНХ
NKNCP	НижнекамскНХ пр.
NGSB	НовгородЭнергоСбыт
NGSBP	НовгородЭнергоСбыт пр.
NMTP	Новороссийский МТП
NVNG	НовосибирскЭн
GMKN	НорНикель ГМК
ODVA	О2ТВ
OGK1	ОГК-1
OGK2	ОГК-2
OGKC	ОГК-3
OGK4	ОГК-4
OGK6	ОГК-6
OMZZ	ОМЗ
OMZZP	ОМЗ пр.
OPIN	ОПИН
OSFD	Объединенный Сибирский фонд
OTOZ	ОйлТехОверсиз
OMSB	ОмскЭнергоСбыт
OMSBP	ОмскЭнергоСбыт пр.
RU0008064118	ОргБанк
OSMP	Останкинский МПК
AKHA	ПАВА
PNTZ	Первоуральский НТЗ
PMSB	ПермЭнергоСбыт
PMSBP	ПермЭнергоСбыт пр.
PMOT	Пермские моторы
PBSB	ПетербургСбытКомпания
PMTL	Полиметалл
PLZL	Полюс Золото
PRIM	Приморское МП
RU14PRMB1006	Приморье-1
RU14PRMB2004	Приморье-2
RU14PRMB3002	Приморье-3
RU14PRMB4000	Приморье-4
RU14PRMB5007	Приморье-5
RU14PRMB6005	Приморье-6
VRAO	РАО Энергосистемы Востока
VRAOP	РАО Энергосистемы Востока пр.
RBCI	РБК ИС
RITK	РИТЭК
RITKP	РИТЭК пр.
RKKE	РКК Энергия им.С.П.Королева
ROSB	РОСБАНК АКБ
RTMC	РТМ
RASP	Распадская
RODN	Родина пр.
ROST	Росинтер Ресторантс Холдинг
ROSN	Роснефть
RTKM	Ростелеком
RTKMP	Ростелеком пр.
HYDR	РусГидро
RUSP	Русполимет
RZSB	РязаньЭнергоСбыт
SZPR	СЗПароходство
SVAV	СОЛЛЕРС
SBER03	Сбербанк России-3
SBERP03	Сбербанк России-3 пр.
SVSB	СвердловЭнергоСбыт
SVSBP	СвердловЭнергоСбыт пр.
SPTL	СевЗапТелеком
SPTLP	СевЗапТелеком пр.
SVTZ	Северский ТЗ
CHMF	Северсталь
SELL	Селестра
SLND	Сибирская земля
STKM	СибирьТелеком
STKMP	СибирьТелеком пр.
SILM	Силовые машины
SILV	Сильвинит
SNTZ	Синарский ТЗ
SYNG	Синергия
HALS	Система-Галс
JNOS	Славнефть-ЯрНОС
MGNZ	Соликамск Магний
SUMZ	Среднеуральский МЗ
STSB	СтавропольЭнергоСбыт
STSBP	СтавропольЭнергоСбыт пр.
SGOK	Стойленский ГОК
SNGS	СургутНГ
SNGSP	СургутНГ пр.
TAMZ	ТАГМЕТ
TGMK	ТАМП
TGKA	ТГК-1
TGKK	ТГК-11
TGKK-001D	ТГК-11-001D
TGKK-002D	ТГК-11-002D
TGKN	ТГК-14
TGKB	ТГК-2
TGKBP	ТГК-2 пр.
TGKD	ТГК-4
TGKDP	ТГК-4 пр.
TGKE	ТГК-5
TGKF	ТГК-6
TGKI	ТГК-9
TRMK	ТМК
TASB	ТамбовЭнергоСбыт
TASBP	ТамбовЭнергоСбыт пр.
RU14TATN3006	Татнефть
RU14TATN3014	Татнефть пр.
TTLK	Таттелеком
TVSB	ТверьЭнергоСбыт
TVSBP	ТверьЭнергоСбыт пр.
TORS	ТомскРаспредКомпания
TORSP	ТомскРаспредКомпания пр.
TOSB	ТомскЭнергоСбыт
TOSBP	ТомскЭнергоСбыт пр.
RU0008959648	Томскнефть
TCBN	ТрансКредитБанк
TRNFP	Транснефть пр.
TUZA	Туймазинский з-д автобетоновозов
TLSB	ТулаСбытКомпания
AZTP-03	Тяжпромарматура-03
AZTP-04	Тяжпромарматура-04
UUAZ	У-УАЗ
UAZA	УАЗ
YKST	УК Стратегия
UDSB	УдмуртЭнергоСбыт
UDSBP	УдмуртЭнергоСбыт пр.
RU0009087035	Удмуртнефть пр.
URSI	УралСвязьИн
URSIP	УралСвязьИн пр.
URKA	Уралкалий
RU14UFMK3008	Уфимский МК-3
FEES	ФСК ЕЭС
PHST	Фармстандарт
FSRV	ФинСервис
FLKO	Финанс-Лизинг
RU0008117536	Финпромбанк
TGKJ	Фортум
MRKH	Холдинг МРСК
MRKHP	Холдинг МРСК пр.
WTCM	ЦМТ
WTCMP	ЦМТ пр.
TZUM	ЦУМ
CNTL	ЦентрТелеграф
CTLK	ЦентрТелеком
CTLKP	ЦентрТелеком пр.
CHZN	ЧЦЗ
CLSB	ЧелябЭнергоСбыт
CLSBP	ЧелябЭнергоСбыт пр.
CHKZ	Челябинский КПЗ
CHMK	Челябинский МК
CHEP	Челябинский ТПЗ
RU0009082291	Черногорнефть
CHSB	ЧитаЭнергоСбыт
CHSBP	ЧитаЭнергоСбыт пр.
OGKE	Энел ОГК-5
RTSB	Энергосбыт РостовЭн
RTSBP	Энергосбыт РостовЭн пр.
UTEL	ЮТК
UTELP	ЮТК пр.
UTAR	ЮТэйр
RU0008927173	ЮганскНГ
RU14YFGA1016	ЮганскНГ пр.
UKUZ	Южный Кузбасс
YKEN	ЯкутскЭн
YKENP	ЯкутскЭн пр.
YRSB	ЯрославльСбытКомпания
YRSBP	ЯрославльСбытКомпания пр.
